11111
10EC1
11PC1
1CCC1
11111
