11111111111111111111111
10000C01EP0C00C00000CC1
1CC00C0000000C100C00001
100001000CC0C10001001C1
1CC0CC0C00C00CC10C000C1
100001C00CCC10000C00001
10010CCCC00C00CC0CCC011
1C00C001010C00000000001
1011C01C0C00C000C00C001
1C10C0CCC000C0000001001
10001000CC0CC01C0000C01
100C0C00000000000C0C101
100C00C0000000000CC0CC1
110CC00000000000CC00101
100C0001000CC00C1000011
10000000000C00C00100001
10000000C00C00C00C000C1
1C0000000C01C00CCCCCCC1
11111111111111111111111
