111111111111111111111111111111111111111111111
1CCCCC0CC000P0000000101000E000000000000000001
1CC0C00000C00001C1000000C0000C0100000C010CCC1
10000000C0000000C0000001000CCC01C0C010C00C001
1001000000C00000C00C100000101C00000C0C010C0C1
1010C00011C00010C00C0000CCC10C1100C1001000C01
100001C000C00010C00C0C0CC0100010C0C01C000C001
100000100100CCC000C0C000000CC0000C000CC0C0001
1C0C00000C00C00000C110000C000C000000000000001
1000C0C0C0000CC0CCC0001C1CC0C0100C000C0000001
100C1100C0C0100000000000000C00CC0C0000C0C0C01
110C000CC000CC000C0000C0C000010000CC000CCC101
1C0C000C101CC10C00C0C00000001C00000C10000C001
100000001000000C00000C000011000001C00CCCCC001
1C001CC000000000C00010C0CC000100001C1000C1001
1CC0C00C1CCCC0100010000000C00000C00C0000100C1
10000000000000000CC0CC10000000C00000000C00CC1
100CCC0C0C0C000CCCCC1C0000110000CC0C100CC00C1
110C0CC00010C01CCC00C00000000CCCC0000C0C0C0C1
1C010C00010C000000001000000100000000C0C00C0C1
1CCCC00000C0000C0C0100C0000010C0000000000CC01
1100100011000000C1C0C0000C00C00C001C00C011001
1C1000CC00C00010000C011C0010C00C00000001000C1
1000000C00010C010000CC0100C1000C000010000CC01
1CC0C000C0CC00000C000000C10C001010100001C01C1
10C0C0C0000000CCC00C000000C0C00C01010CCCCCCC1
111111111111111111111111111111111111111111111
