111111111111111
10C00C0C00C0001
1000000P00000C1
1000CCC0000EC01
10000C10000C111
101C00000CC0CC1
1000010CCCCCCC1
111111111111111
