1111111
110E1C1
1000001
1C000C1
1PCCCC1
1111111
